"filename", "language", "Python", "Markdown", "Shell Script", "YAML", "pip requirements", "comment", "blank", "total"
"/data/wzh_fd/workspace/tiny-mm-rag-agent/README.md", "Markdown", 0, 71, 0, 0, 0, 0, 12, 83
"/data/wzh_fd/workspace/tiny-mm-rag-agent/config/config.yaml", "YAML", 0, 0, 0, 20, 0, 0, 7, 27
"/data/wzh_fd/workspace/tiny-mm-rag-agent/main.py", "Python", 212, 0, 0, 0, 0, 12, 22, 246
"/data/wzh_fd/workspace/tiny-mm-rag-agent/preprocessing/chunk.py", "Python", 70, 0, 0, 0, 0, 7, 7, 84
"/data/wzh_fd/workspace/tiny-mm-rag-agent/preprocessing/parsePDF.sh", "Shell Script", 0, 0, 36, 0, 0, 72, 28, 136
"/data/wzh_fd/workspace/tiny-mm-rag-agent/preprocessing/parser/__init__.py", "Python", 30, 0, 0, 0, 0, 1, 10, 41
"/data/wzh_fd/workspace/tiny-mm-rag-agent/preprocessing/parser/base_parser.py", "Python", 31, 0, 0, 0, 0, 5, 8, 44
"/data/wzh_fd/workspace/tiny-mm-rag-agent/preprocessing/parser/doc_parser.py", "Python", 56, 0, 0, 0, 0, 2, 15, 73
"/data/wzh_fd/workspace/tiny-mm-rag-agent/preprocessing/parser/img_parser.py", "Python", 25, 0, 0, 0, 0, 1, 10, 36
"/data/wzh_fd/workspace/tiny-mm-rag-agent/preprocessing/parser/md_parser.py", "Python", 61, 0, 0, 0, 0, 3, 21, 85
"/data/wzh_fd/workspace/tiny-mm-rag-agent/preprocessing/parser/pdf_parser.py", "Python", 102, 0, 0, 0, 0, 4, 23, 129
"/data/wzh_fd/workspace/tiny-mm-rag-agent/preprocessing/parser/ppt_parser.py", "Python", 57, 0, 0, 0, 0, 2, 15, 74
"/data/wzh_fd/workspace/tiny-mm-rag-agent/preprocessing/parser/txt_parser.py", "Python", 56, 0, 0, 0, 0, 3, 17, 76
"/data/wzh_fd/workspace/tiny-mm-rag-agent/preprocessing/reptile.py", "Python", 81, 0, 0, 0, 0, 18, 9, 108
"/data/wzh_fd/workspace/tiny-mm-rag-agent/preprocessing/sentence_splitter.py", "Python", 55, 0, 0, 0, 0, 4, 5, 64
"/data/wzh_fd/workspace/tiny-mm-rag-agent/requirements.txt", "pip requirements", 0, 0, 0, 0, 25, 3, 1, 29
"/data/wzh_fd/workspace/tiny-mm-rag-agent/server.py", "Python", 63, 0, 0, 0, 0, 7, 20, 90
"/data/wzh_fd/workspace/tiny-mm-rag-agent/tools/__init__.py", "Python", 0, 0, 0, 0, 0, 0, 1, 1
"/data/wzh_fd/workspace/tiny-mm-rag-agent/tools/agent/__init__.py", "Python", 0, 0, 0, 0, 0, 0, 1, 1
"/data/wzh_fd/workspace/tiny-mm-rag-agent/tools/agent/mcp-client.py", "Python", 13, 0, 0, 0, 0, 0, 6, 19
"/data/wzh_fd/workspace/tiny-mm-rag-agent/tools/agent/mcp-email-server.py", "Python", 47, 0, 0, 0, 0, 12, 6, 65
"/data/wzh_fd/workspace/tiny-mm-rag-agent/tools/agent/mcp-rag-server.py", "Python", 114, 0, 0, 0, 0, 11, 18, 143
"/data/wzh_fd/workspace/tiny-mm-rag-agent/tools/agent/mcp-sql-server.py", "Python", 118, 0, 0, 0, 0, 80, 25, 223
"/data/wzh_fd/workspace/tiny-mm-rag-agent/tools/agent/memo.py", "Python", 115, 0, 0, 0, 0, 0, 6, 121
"/data/wzh_fd/workspace/tiny-mm-rag-agent/tools/agent/prompt.py", "Python", 244, 0, 0, 0, 0, 21, 56, 321
"/data/wzh_fd/workspace/tiny-mm-rag-agent/tools/llm/__init__.py", "Python", 0, 0, 0, 0, 0, 0, 1, 1
"/data/wzh_fd/workspace/tiny-mm-rag-agent/tools/llm/deepseek.py", "Python", 43, 0, 0, 0, 0, 8, 16, 67
"/data/wzh_fd/workspace/tiny-mm-rag-agent/tools/llm/qwenvl.py", "Python", 78, 0, 0, 0, 0, 21, 13, 112
"/data/wzh_fd/workspace/tiny-mm-rag-agent/tools/searcher/__init__.py", "Python", 0, 0, 0, 0, 0, 0, 1, 1
"/data/wzh_fd/workspace/tiny-mm-rag-agent/tools/searcher/gme_inference.py", "Python", 256, 0, 0, 0, 0, 31, 44, 331
"/data/wzh_fd/workspace/tiny-mm-rag-agent/tools/searcher/reanker.py", "Python", 127, 0, 0, 0, 0, 11, 21, 159
"/data/wzh_fd/workspace/tiny-mm-rag-agent/tools/searcher/retriever_bm25.py", "Python", 189, 0, 0, 0, 0, 18, 44, 251
"/data/wzh_fd/workspace/tiny-mm-rag-agent/tools/searcher/retriever_embed.py", "Python", 173, 0, 0, 0, 0, 19, 30, 222
"/data/wzh_fd/workspace/tiny-mm-rag-agent/tools/searcher/searcher.py", "Python", 71, 0, 0, 0, 0, 14, 15, 100
"Total", "-", 2487, 71, 36, 20, 25, 390, 534, 3563